name,latitude,longitude,free_bikes,empty_slots,total_docks
"300073 - Prince of Wales Drive, Battersea Park",51.47515398,-0.159169801,13,5,18
"003447 - Gloucester Road (North), Kensington",51.49792478,-0.183834706,0,17,17
"200213 - Durant Street, Bethnal Green",51.52868155,-0.065550321,11,10,21
"003488 - Charles II Street, West End",51.50844614,-0.131961389,0,22,22
"001126 - North Audley Street, Mayfair",51.5129118,-0.153645496,0,14,14
"300004 - Harris Academy, Bermondsey",51.492668,-0.072350665,14,3,17
"001209 - Empire Square, The Borough",51.50082346,-0.089740764,23,22,45
"001189 - Long Lane , Bermondsey",51.49907558,-0.085666316,18,2,20
"001068 - Norton Folgate, Liverpool Street",51.52111369,-0.078869751,0,23,23
"001057 - Hardwick Street, Clerkenwell",51.5278427,-0.1080682,23,7,30
"001204 - Queen's Gate (North), Kensington",51.50102668,-0.180246101,0,38,38
"200052 - Exhibition Road Museums 2, South Kensington",51.495947,-0.17368958,1,13,14
"001158 - St. Martin's Street, West End",51.50908747,-0.129697889,1,16,17
"001143 - Kensington Church Street, Kensington",51.50315739,-0.191496313,8,8,16
"200072 - Houndsditch, Aldgate",51.514449,-0.077178979,1,27,28
"002701 - Columbia Road, Shoreditch",51.528187,-0.075375,19,1,20
"001190 - Kennington Lane Rail Bridge, Vauxhall",51.4863434,-0.12249239999999872,26,3,29
"200249 - Queen Mary's, Mile End",51.522507,-0.041378,3,38,41
"200050 - Naval Row, Blackwall",51.508981,-0.00699,19,2,21
"001152 - Marylebone Lane, Marylebone",51.51475963,-0.148105415,0,21,21
"300212 - Birkenhead Street, King's Cross",51.5301998755,-0.122299440803,26,1,27
"001174 - Alderney Street, Pimlico",51.48805753,-0.140741432,12,0,12
"001099 - Frampton Street, Paddington",51.5233534,-0.175116099,26,4,30
"200127 - East India DLR, Blackwall",51.509474,-0.002275,32,16,48
"200198 - Seymour Place, Marylebone",51.520331,-0.163667,3,24,27
"001231 - Queen's Gate, Kensington Gardens",51.5017154373867,-0.1798541843891,2,16,18
"200017 - Lancaster Gate , Bayswater",51.511654,-0.179668,20,16,36
"200118 - Albert Street, Camden Town",51.537706,-0.14480190000000448,16,9,25
"200091 - Wandsworth Town Station, Wandsworth",51.46086446,-0.187427294,29,1,30
"001191 - Barbican Centre, Barbican",51.52004497,-0.092176447,0,19,19
"010623 - Greycoat Street , Westminster",51.49459148,-0.134234258,3,14,17
"200149 - Watney Street, Shadwell",51.511542,-0.056667,14,11,25
"001019 - Ampton Street , Clerkenwell",51.52728093,-0.11829517,8,12,20
"300058 - The Vale, Chelsea",51.48512191,-0.174971902,4,18,22
"200073 - Cephas Street, Bethnal Green",51.522561,-0.054883,10,11,21
"200180 - South Park, Sands End",51.46706414,-0.193502076,23,4,27
"300081 - Haggerston Road, Haggerston",51.53932857,-0.074284675,33,2,35
"200189 - Phene Street, Chelsea",51.48498496,-0.167919869,7,14,21
"200209 - Shepherd's Bush Road North, Shepherd's Bush",51.5015946,-0.222293381,30,1,31
"200077 - Vicarage Crescent, Battersea",51.47287627,-0.176267008,12,18,30
"002587 - Wormwood Street, Liverpool Street",51.51615461,-0.082422399,0,15,15
"200190 - Queen's Circus, Battersea Park",51.47761941,-0.149551631,25,2,27
"200220 - Blythe Road West, Shepherd's Bush",51.49968,-0.221791551,19,0,19
"001037 - Park Lane , Hyde Park",51.5100172,-0.157275636,2,22,24
"300208 - Lavington Street, Bankside",51.5052241745,-0.0980318118664,12,17,29
"200168 - Southern Grove, Bow",51.523538,-0.030556,8,9,17
"002641 - New North Road 2, Hoxton",51.53114,-0.086016,19,3,22
"001155 - Regency Street, Westminster",51.49206037,-0.132224622,17,4,21
"200218 - Addison Road, Holland Park",51.504199,-0.210941,10,14,24
"300209 - Albert Square, Stockwell",51.4765900593,-0.118256789081,32,0,32
"003449 - Breams Buildings, Holborn",51.51593725,-0.111778348,0,23,23
"010629 - Rotherhithe Roundabout, Rotherhithe",51.499169,-0.055846029,15,4,19
"200194 - Clarence Walk, Stockwell",51.47073264,-0.126994068,27,0,27
"001122 - Ashley Place, Victoria",51.49616092,-0.140947636,3,18,21
"001147 - Clifton Road, Maida Vale",51.52557531,-0.179592915,21,0,21
"001144 - Poured Lines, Bankside",51.50669284,-0.103137426,9,22,31
"200238 - Westferry DLR, Limehouse",51.509303,-0.025996,27,11,38
"200106 - Spanish Road, Clapham Junction",51.45922541,-0.180884959,19,10,29
"300024 - Dunston Road , Haggerston",51.53658514,-0.075885686,15,25,40
"001121 - Lexham Gardens, Kensington",51.49586666,-0.191933711,10,9,19
"001109 - Wellington Arch, Hyde Park",51.50274025,-0.149569201,4,24,28
"001192 - Embankment (Savoy), Strand",51.50963123,-0.119047563,22,19,41
"003450 - Great Titchfield Street, Fitzrovia",51.52025302,-0.141327271,2,16,18
"200153 - Blythe Road, Olympia",51.496927,-0.21350087,17,6,23
"001038 - Harrington Square 1, Camden Town",51.53301907,-0.139174593,18,7,25
"022169 - Wren Street, Holborn",51.524564,-0.116279,2,29,31
"300205 - Cromer Street, Bloomsbury",51.528279,-0.11955857,25,3,28
"022167 - Millharbour, Millwall",51.496137,-0.019355,18,1,19
"300065 - Clapham Common North Side, Clapham Common",51.46134382,-0.159322467,24,12,36
"200086 - Ilchester Gardens, Bayswater",51.51244,-0.19096,8,11,19
"300061 - Crimscott Street, Bermondsey",51.495598,-0.078893,18,0,18
"200162 - Watney Market, Stepney",51.5142228,-0.055656,20,31,51
"001026 - Roscoe Street, St. Luke's",51.52295439,-0.094934859,3,15,18
"300008 - Normand Park, West Kensington",51.48438657,-0.20481514,23,0,23
"200116 - Vereker Road, West Kensington",51.48959104,-0.209378594,24,7,31
"200007 - Holden Street, Battersea",51.4687905,-0.158230901,12,8,20
"200063 - Mexfield Road, East Putney",51.45682071,-0.202802098,8,10,18
"200202 - Storey's Gate, Westminster",51.50070305,-0.129698963,2,17,19
"300245 - Clapham Road, Lingham Street, Stockwell",51.4714330677,-0.123670735702,29,0,29
"200204 - Northfields, Wandsworth",51.46095151,-0.20066766,26,1,27
"001211 - Bunhill Row, Moorgate",51.52085887,-0.089887855,0,29,29
"200028 - Elysium Place, Fulham",51.47107905,-0.207842908,13,8,21
"001065 - Aldersgate Street, Barbican",51.5208417,-0.097340162,1,12,13
"001043 - Museum of London, Barbican",51.51782144,-0.096496865,0,50,50
"003459 - Collingham Gardens, Earl's Court",51.4916156,-0.186753859,12,1,13
"001176 - Waterloo Road, South Bank",51.50486,-0.113001,15,0,15
"200188 - Neville Gill Close, Wandsworth",51.45475251,-0.195197203,24,7,31
"200203 - King Edward Street, St Pauls",51.51601,-0.0985,0,20,20
"300076 - Lots Road, West Chelsea",51.4795738,-0.17903854,20,4,24
"200057 - Belford House, Haggerston",51.5366541,-0.07023031,10,29,39
"001066 - Calshot Street , King's Cross",51.53136059,-0.117069978,6,18,24
"200251 - Bow Road Station, Bow",51.527058,-0.025296,10,32,42
"003458 - Waterloo Place, St. James's",51.50663341,-0.131773845,4,15,19
"022161 - Vincent Street, Pimlico",51.493072,-0.129925,11,5,16
"010627 - Grosvenor Square, Mayfair",51.51217033,-0.150481272,2,15,17
"001059 - Albert Embankment, Vauxhall",51.4904357,-0.1228069000000005,20,3,23
"200143 - Lancaster Drive, Blackwall",51.503143,-0.008428,6,19,25
"003455 - Arundel Street, Temple",51.511726,-0.11385596,0,17,17
"300207 - Gauden Road, Clapham",51.464995,-0.13090885,27,1,28
"001022 - Brunswick Square, Bloomsbury",51.52395143,-0.122502346,2,19,21
"200230 - Maplin Street, Mile End",51.525501,-0.032267204,1,32,33
"200171 - Peterborough Road, Sands End",51.46904022,-0.19627483,23,5,28
"002681 - Harriet Street, Knightsbridge",51.50024195,-0.15934065,4,19,23
"002589 - Pembridge Villas, Notting Hill",51.51108452,-0.197524944,10,3,13
"300084 - Sirdar Road, Avondale",51.51092871,-0.214594781,18,7,25
"001105 - LMU Commercial Road, Whitechapel",51.51492456,-0.066078037,4,9,13
"003427 - Fanshaw Street, Hoxton",51.52953709,-0.083353323,5,30,35
"200062 - William Morris Way, Sands End",51.46881971,-0.184318843,12,14,26
"200210 - Westbridge Road, Battersea",51.47768469,-0.170329317,9,18,27
"000997 - Worship Street, Shoreditch",51.521668,-0.079608554,0,49,49
"001110 - Palace Gate, Kensington Gardens",51.50204238,-0.184400221,0,11,11
"200110 - Bishop's Bridge Road West, Bayswater",51.51616,-0.18697,17,0,17
"001194 - Westminster University, Marylebone",51.52248185,-0.154907218,6,9,15
"001002 - Holy Trinity Brompton, Knightsbridge",51.49705603,-0.168917077,10,16,26
"300067 - Grenfell Road, Avondale",51.5129006,-0.214762686,21,3,24
"001140 - Grosvenor Road, Pimlico",51.4853572,-0.142207481,19,9,28
"000964 - Bath Street, St. Luke's",51.52589324,-0.090847761,14,3,17
"300050 - Walworth Square, Walworth",51.491327,-0.096518684,24,0,24
"300083 - Duke Street Hill, London Bridge",51.50630441,-0.087262995,0,19,19
"001221 - St. George Street, Mayfair",51.51196,-0.142783033,0,17,17
"200160 - Langdon Park, Poplar",51.51549,-0.013475,12,11,23
"001218 - Flood Street, Chelsea",51.48802358,-0.166878535,1,30,31
"003432 - Farringdon Lane, Clerkenwell",51.52352001,-0.108340165,1,14,15
"010630 - George Place Mews, Marylebone",51.51689296,-0.158249929,2,13,15
"000980 - Malet Street, Bloomsbury",51.52168078,-0.130431727,0,49,49
"200129 - Charlotte Terrace, Angel",51.53639219,-0.112721065,18,7,25
"300213 - Monier Road, Hackney Wick",51.5403115,-0.021630359,25,0,25
"300037 - Ravenscourt Park Station, Hammersmith",51.49422354,-0.236769936,14,9,23
"200211 - Union Grove, Wandsworth Road",51.472993,-0.133972,36,6,42
"300018 - Charing Cross Hospital, Hammersmith",51.48728535,-0.217995921,16,4,20
"001024 - Park Street, Bankside",51.50597426,-0.092754157,1,16,17
"022165 - Fisherman's Walk West, Canary Wharf",51.50623,-0.02296,28,7,35
"300023 - All Saints Church, Portobello",51.51632095,-0.202608612,30,6,36
"001082 - Borough Road, Elephant & Castle",51.49889832,-0.100440521,27,13,40
"300007 - Rifle Place, Avondale",51.509224,-0.216016,14,7,21
"001060 - Torrens Street, Angel",51.53219984,-0.105480698,10,7,17
"300070 - Imperial Wharf Station, Sands End",51.474665,-0.18316517,24,0,24
"001138 - Elizabeth Bridge, Victoria",51.49236962,-0.147478734,20,12,32
"300229 - Sidney Road, Stockwell",51.469202,-0.11902256,25,0,25
"001077 - Royal London Hospital, Whitechapel",51.518675,-0.06111,25,14,39
"200243 - St. John's Park, Cubitt Town",51.496454,-0.009506,14,9,23
"200121 - Shoreditch Court, Haggerston",51.53908372,-0.070329419,29,6,35
"001106 - Rampayne Street, Pimlico",51.48997562,-0.132845681,20,1,21
"200247 - Globe Town Market, Bethnal Green",51.528869,-0.047548,15,2,17
"022172 - Bromley High Street, Bow",51.528828,-0.013258,6,6,12
"003446 - De Vere Gardens, Kensington",51.50173726,-0.184980612,14,11,25
"001173 - Gloucester Terrace, Bayswater",51.51791921,-0.188098863,20,0,20
"001214 - Kensington Olympia Station, Olympia",51.49815779,-0.209494128,13,12,25
"200150 - Cantrell Road, Bow",51.521564,-0.022694,10,14,24
"002662 - Butler Place, Westminster",51.49782999,-0.135440826,3,15,18
"001103 - Gloucester Street, Pimlico",51.49096258,-0.139625122,23,1,24
"002693 - Shouldham Street, Marylebone",51.51809,-0.163609,5,9,14
"001012 - Christopher Street, Liverpool Street",51.52128377,-0.084605692,4,28,32
"200114 - Orbel Street, Battersea",51.47453545,-0.170210533,11,15,26
"001131 - Graham Street, Angel",51.53266186,-0.099981142,19,5,24
"200141 - Westfield Ariel Way, White City",51.509158,-0.224103,38,3,41
"001197 - Sackville Street, Mayfair",51.51004801,-0.138846453,0,16,16
"200151 - Hoxton Station, Hoxton",51.531091,-0.075901,5,15,20
"003429 - Abbey Orchard Street, Westminster",51.4981256,-0.1321021999999914,1,26,27
"002666 - Howick Place, Westminster",51.49675303,-0.138733562,1,20,21
"300090 - Blenheim Crescent, Ladbroke Grove",51.51510818,-0.208565479,13,5,18
"200205 - Montserrat Road , Putney",51.46321128,-0.215550761,21,2,23
"300046 - Alma Road, Wandsworth",51.45799126,-0.184806157,23,5,28
"001053 - Clerkenwell Green, Clerkenwell",51.52326004,-0.104708922,4,15,19
"200008 - Portman Square, Marylebone",51.516204,-0.155525,0,17,17
"000968 - Warwick Row, Westminster",51.497998,-0.14296064,0,16,16
"001200 - Ontario Street, Elephant & Castle",51.49652013,-0.101384068,10,4,14
"200232 - Preston's Road, Cubitt Town",51.499286,-0.009152,15,6,21
"300056 - Mile End Stadium, Mile End",51.51854104,-0.034903714,12,6,18
"003489 - Broadwick Street, Soho",51.5136846,-0.135580879,0,14,14
"003426 - Lansdowne Drive, Hackney Central",51.539834,-0.062806212,21,2,23
"022181 - Camley Street, Camden Town",51.53792,-0.13052999999999315,9,9,18
"300014 - Falcon Road, Clapham Junction",51.46663393,-0.169821175,26,1,27
"001100 - Strand, Strand",51.512582,-0.11505729999998948,0,31,31
"200241 - Bonner Gate, Victoria Park",51.53341,-0.049591815,20,0,20
"300222 - Fore Street, Guildhall",51.518093,-0.0914017,2,22,24
"003439 - Tavistock Place, Bloomsbury",51.5262503,-0.123509611,9,10,19
"022158 - Exhibition Road Museums 1, South Kensington",51.496468,-0.17379696,0,11,11
"001118 - Hampton Street, Walworth",51.49217002,-0.101536865,18,0,18
"001070 - Bricklayers Arms, Borough",51.49506109,-0.085814489,28,0,28
"000970 - Scala Street, Fitzrovia",51.51991453,-0.136039674,0,20,20
"300026 - All Saints' Road, Portobello",51.5190427,-0.204764421,6,15,21
"200169 - Ashley Crescent, Battersea",51.46718562,-0.152248582,28,0,28
"001156 - Bedford Way, Bloomsbury",51.52367314,-0.128377673,6,17,23
"001154 - Kennington Road, Vauxhall",51.49571828,-0.110889274,35,0,35
"200005 - New Cavendish Street, Marylebone",51.519167,-0.147983,2,15,17
"001114 - Pont Street, Knightsbridge",51.4968865,-0.161203828,1,22,23
"003425 - Northington Street , Holborn",51.5222641,-0.114079481,0,19,19
"200212 - Blackfriars Station, St. Paul's",51.511934,-0.10307894,0,34,34
"000967 - Golden Lane, Barbican",51.52174785,-0.094475072,1,24,25
"300022 - Evesham Street, Avondale",51.51148696,-0.218190203,2,27,29
"001067 - St. James's Square, St. James's",51.50742485,-0.134621209,0,38,38
"300233 - Aquatic Centre, Queen Elizabeth Olympic Park",51.541482,-0.010437700000011318,11,16,27
"022170 - Kennington Station, Kennington",51.488852,-0.105593,19,1,20
"002670 - Paddington Green, Paddington",51.520205,-0.174593,1,17,18
"001075 - Hyde Park Corner, Hyde Park",51.50311799,-0.153520935,1,30,31
"300034 - St. Mark's Road, North Kensington",51.51687069,-0.213872396,12,8,20
"022179 - Exhibition Road, Knightsbridge",51.499917,-0.174554,0,18,18
"001006 - Percy Street, Bloomsbury",51.51863,-0.13267630000001418,0,27,27
"001128 - Westbourne Green, Westbourne",51.522168,-0.1928141999999866,13,6,19
"200215 - Greyhound Road, Hammersmith",51.48606206,-0.214428378,30,5,35
"300230 - Wynne Road, Stockwell",51.469217,-0.11268674,25,0,25
"200172 - Lansdowne Road, Ladbroke Grove",51.50748124,-0.205535908,12,16,28
"200010 - Manresa Road, Chelsea",51.486892,-0.170983,10,7,17
"300236 - Bevington Road West, North Kensington",51.5212,-0.208888173,18,5,23
"300232 - Riverlight South, Nine Elms",51.4813354746,-0.138212295869,22,3,25
"300062 - South Bermondsey Station, Bermondsey",51.488067,-0.057774596,15,7,22
"003422 - Charlbert Street, St. John's Wood",51.53430039,-0.1680743,13,2,15
"200009 - Stebondale Street, Cubitt Town",51.489096,-0.009205,21,4,25
"300242 - Allington Street, Victoria",51.496863,-0.1429434,4,21,25
"001096 - Bayswater Road, Hyde Park",51.511933,-0.174411,13,8,21
"200133 - South Lambeth Road, Vauxhall",51.481747,-0.124642,18,3,21
"001028 - William IV Street, Strand",51.50946212,-0.124749274,6,17,23
"200201 - Battersea Church Road, Battersea",51.47696496,-0.174347066,24,0,24
"300249 - Westminster Pier, Westminster",51.501513,-0.12382322,12,9,21
"003487 - Campden Hill Road, Notting Hill",51.50658458,-0.199004026,1,13,14
"200032 - Kennington Oval, Oval",51.483145,-0.113134,33,0,33
"200034 - Wapping Lane, Wapping",51.504749,-0.057544,20,5,25
"200099 - Upper Bank Street, Canary Wharf",51.503083,-0.017676,17,17,34
"200154 - Hansard Mews, Holland Park",51.503802,-0.215808,18,1,19
"300055 - Stewart's Road, Wandsworth Road",51.47311696,-0.137235175,17,11,28
"200068 - Somerset House, Strand",51.509943,-0.117619,7,33,40
"003465 - Eccleston Place, Victoria",51.49395092,-0.147624377,18,1,19
"300012 - Irene Road, Parsons Green",51.4737636,-0.197010096,18,22,40
"003506 - Stanhope Gate, Mayfair",51.50686435,-0.150666888,0,20,20
"010631 - Holland Park, Kensington",51.502319,-0.200742,6,23,29
"200161 - Clinton Road, Mile End",51.525941,-0.036017,16,19,35
"001196 - Vincent Square, Westminster",51.49398524,-0.136928582,7,12,19
"200142 - Hammersmith Road, Hammersmith",51.493267,-0.21985,5,14,19
"001073 - Kennington Road Post Office, Oval",51.48478899,-0.110683213,16,0,16
"300003 - Eel Brook Common, Walham Green",51.47625965,-0.193254007,22,2,24
"300238 - Southwark Street, Bankside",51.5054099403,-0.0983410884509,3,18,21
"000981 - British Museum, Bloomsbury",51.51908011,-0.124678402,2,32,34
"001101 - Knightsbridge, Hyde Park",51.50275704,-0.155349725,10,31,41
"001091 - St. John's Wood Church, The Regent's Park",51.530529,-0.167515,4,46,50
"003479 - Old Brompton Road, South Kensington",51.49094565,-0.181190899,10,19,29
"300096 - Tallis Street, Temple",51.511891,-0.107349,1,22,23
"300246 - Belvedere Road 2, South Bank",51.50621,-0.114842,24,13,37
"200088 - Clarges Street, Mayfair",51.507326,-0.145827,0,16,16
"022176 - Reardon Street, Wapping",51.506946,-0.058681,14,2,16
"200237 - Parson's Green , Parson's Green",51.472817,-0.199783,4,14,18
"200004 - Lightermans Road, Millwall",51.499041,-0.020157,5,26,31
"002699 - Snow Hill, Farringdon",51.51733427,-0.103604248,0,15,15
"003460 - Warwick Square, Pimlico",51.48985626,-0.141923621,19,0,19
"300227 - Timber Lodge, Queen Elizabeth Olympic Park",51.546805,-0.01469126,11,24,35
"003469 - Cadogan Place, Knightsbridge",51.49464523,-0.158105512,0,33,33
"200207 - Hartington Road, Stockwell",51.47787084,-0.126874471,34,0,34
"200059 - Crisp Road, Hammersmith",51.48810829,-0.22660621,37,4,41
"001129 - Sun Street, Liverpool Street",51.520009,-0.083935724,0,23,23
"001132 - Albert Gate, Hyde Park",51.50295379,-0.158456089,1,32,33
"200070 - Arlington Road, Camden Town",51.539957,-0.145246,6,17,23
"001020 - Leonard Circus , Shoreditch",51.5246962,-0.08443930000001387,6,36,42
"200165 - Wellington Row, Bethnal Green",51.528222,-0.069743,25,8,33
"003491 - Princes Square, Bayswater",51.5134891,-0.191351186,9,6,15
"003477 - Porchester Place, Paddington",51.5147461,-0.1651640000000043,4,11,15
"003478 - Guildhouse Street, Victoria",51.49234577,-0.141334487,12,1,13
"200042 - York Hall, Bethnal Green",51.528936,-0.055894,11,16,27
"200152 - Pitfield Street North,Hoxton",51.53558,-0.08249,24,3,27
"200137 - Caldwell Street, Stockwell",51.477839,-0.116493,38,0,38
"001010 - Cartwright Gardens , Bloomsbury",51.52635795,-0.125979294,4,16,20
"022174 - Granby Street, Shoreditch",51.525645,-0.069543,7,28,35
"001095 - LSBU (Borough Road), Elephant & Castle",51.49874469,-0.103132904,26,9,35
"010632 - Kensington Town Hall, Kensington",51.50194596,-0.194392952,3,15,18
"001090 - Warren Street Station, Euston",51.52443845,-0.138019439,0,23,23
"001163 - Wardour Street, Soho",51.51251523,-0.133201961,2,13,15
"300044 - Putney Bridge Road, East Putney",51.46199911,-0.206240805,19,10,29
"000988 - Great Russell Street, Bloomsbury",51.51772703,-0.127854211,0,23,23
"200184 - Erin Close, Walham Green",51.47946386,-0.195777222,20,2,22
"002683 - Millbank Tower, Pimlico",51.49188409,-0.125674815,21,1,22
"001136 - London Zoo,  The Regent's Park",51.53583617,-0.156285395,8,23,31
"200027 - Ford Road, Old Ford",51.532513,-0.033085,12,4,16
"200092 - Mudchute DLR, Cubitt Town",51.490645,-0.014582,24,3,27
"200167 - Twig Folly Bridge, Mile End",51.530326,-0.042744,9,9,18
"200236 - Greenberry Street, St.John's Wood",51.53256,-0.16862,16,10,26
"001130 - Grove End Road, St. John's Wood",51.53088935,-0.176770502,15,5,20
"003451 - Golden Square, Soho",51.5118973,-0.137043852,0,16,16
"001124 - Sumner Place, South Kensington",51.49121192,-0.173715911,0,17,17
"200058 - Northdown Street, King's Cross",51.531066,-0.11934,4,17,21
"300051 - Hibbert Street, Battersea",51.46517078,-0.18038939,20,13,33
"001058 - Edgware Road Station, Marylebone",51.519968,-0.169774,3,61,64
"200054 - Jubilee Crescent, Cubitt Town",51.493381,-0.007542,50,2,52
"200036 - Bell Lane, Liverpool Street",51.517475,-0.075855,1,20,21
"001104 - Claremont Square, Angel",51.53166681,-0.109914711,9,7,16
"001102 - Leman Street, Aldgate",51.51236389,-0.06954201,4,33,37
"001040 - West Smithfield Rotunda, Farringdon",51.51821864,-0.100791005,3,12,15
"001007 - Drury Lane, Covent Garden",51.51477076,-0.12221963,1,25,26
"300201 - Coram Street, Bloomsbury",51.524,-0.12640984,3,26,29
"300052 - Parsons Green Station, Parsons Green",51.475089,-0.201968,30,23,53
"003482 - Beaumont Street, Marylebone",51.52200801,-0.151359288,3,20,23
"001208 - Dickens Square, Borough",51.49679128,-0.093913472,28,4,32
"003505 - Marloes Road, Kensington",51.496481,-0.192404,10,3,13
"200131 - Clarkson Street, Bethnal Green",51.528692,-0.059091,10,19,29
"001171 - New Road 1 , Whitechapel",51.518154,-0.062697,12,22,34
"001085 - Old Quebec Street, Marylebone",51.51457763,-0.158264483,0,14,14
"300071 - Elgin Avenue, Maida Hill",51.524309,-0.20123459999999227,3,11,14
"200224 - Colet Gardens, Hammersmith",51.491093,-0.216493,16,14,30
"000965 - Tachbrook Street, Victoria",51.49211134,-0.138364847,12,1,13
"200208 - Sugden Road, Clapham",51.46512358,-0.157788279,18,0,18
"001089 - Queen's Gate (Central), South Kensington",51.49396755,-0.17873226,0,31,31
"200255 - Devons Road, Bow",51.52512,-0.015578,20,19,39
"200199 - Stanley Grove, Battersea",51.47047503,-0.152130083,23,0,23
"200163 - Jubilee Plaza, Canary Wharf",51.5034,-0.020242300000006708,13,43,56
"001071 - Tower Gardens , Tower",51.50950627,-0.075459482,3,19,22
"001000 - Vauxhall Cross, Vauxhall",51.48591714,-0.124469948,8,8,16
"200094 - St. Bride Street, Holborn",51.51505991,-0.10534448,0,25,25
"300221 - Battersea Power Station, Battersea Park",51.4835074867,-0.147714557371,9,17,26
"200122 - Hawley Crescent, Camden Town",51.54100708,-0.14326094,8,13,21
"200147 - Salmon Lane, Limehouse",51.514115,-0.033828,29,4,33
"002639 - King Edward Walk, Waterloo",51.49775,-0.10988,22,0,22
"003495 - Wells Street, Fitzrovia",51.51734403,-0.138072691,0,34,34
"001045 - Jewry Street, Aldgate",51.51340693,-0.076793375,0,14,14
"001001 - West Cromwell Road, Earl's Court",51.49372451,-0.198286569,21,2,23
"200093 - Thurtle Road, Haggerston",51.534776,-0.071881,15,6,21
"300049 - Aylward Street, Stepney",51.51563007,-0.049067243,13,8,21
"200223 - Ashmole Estate, Oval",51.48267821,-0.117661574,26,7,33
"001133 - Baylis Road, Waterloo",51.50144456,-0.110699309,7,14,21
"000961 - Union Street, The Borough",51.50368837,-0.098497684,2,13,15
"200233 - South Quay East, Canary Wharf",51.50196,-0.016251,22,11,33
"200108 - Bishop's Bridge Road East, Bayswater",51.5171,-0.18377,9,9,18
"001162 - Dorset Square, Marylebone",51.5225965,-0.161113413,14,0,14
"002637 - Bermondsey Street, Bermondsey",51.49785559,-0.081608045,22,0,22
"001135 - Claverton Street, Pimlico",51.48483991,-0.138089062,31,1,32
"003436 - Derry Street, Kensington",51.50136494,-0.191462381,2,13,15
"001175 - Mallory Street, Marylebone",51.52505151,-0.166304359,6,14,20
"300098 - Hurlingham Park, Parsons Green",51.470131,-0.20464,14,5,19
"001127 - Risinghill Street, Angel",51.5333196,-0.1117811999999958,9,12,21
"001031 - Nesham Street, Wapping",51.507131,-0.06691,14,1,15
"001182 - Notting Hill Gate Station, Notting Hill",51.50935342,-0.196422,0,26,26
"200193 - Snowsfields, London Bridge",51.50215353,-0.083632928,5,25,30
"200214 - Woodstock Grove, Shepherd's Bush",51.50403821,-0.217400093,22,1,23
"300202 - Kings Gate House, Westminster",51.4976984561,-0.137598896295,2,21,23
"300240 - Lincoln's Inn Fields, Holborn",51.5162778834,-0.118272991635,0,26,26
"001049 - Finsbury Leisure Centre, St. Luke's",51.52600832,-0.096317627,16,3,19
"300042 - Upper Richmond Road, Putney",51.45971528,-0.212145939,14,11,25
"001228 - Southampton Street, Strand",51.51070161,-0.121723604,0,13,13
"001011 - Argyle Street, Kings Cross",51.529416,-0.12394439999999918,18,22,40
"001078 - Lambeth Road, Vauxhall",51.49488108,-0.117974901,5,11,16
"200221 - Crabtree Lane, Fulham",51.48294452,-0.219346128,23,2,25
"001113 - Trebovir Road, Earl's Court",51.49085368,-0.196170309,14,2,16
"002669 - Charlotte Street, Fitzrovia",51.51953043,-0.13577731,0,10,10
"200056 - Vauxhall Walk, Vauxhall",51.488124,-0.120903,27,0,27
"022178 - Lindfield Street, Poplar",51.513757,-0.020467,10,33,43
"003483 - Fashion Street, Whitechapel",51.51838043,-0.073438925,0,29,29
"001018 - Phillimore Gardens, Kensington",51.49960695,-0.197574246,20,17,37
"001226 - Macclesfield Rd, St Lukes",51.529423,-0.097122,27,0,27
"300235 - York Way, Kings Cross",51.541596,-0.12544145,12,12,24
"300094 - Plough Terrace, Clapham Junction",51.46230566,-0.175407201,11,20,31
"001052 - Soho Square , Soho",51.51563144,-0.132328837,0,54,54
"200023 - Heath Road, Battersea",51.46866929,-0.146544642,18,0,18
"003490 - Southwick Street, Paddington",51.51595344,-0.169249375,2,13,15
"300214 - Blackfriars Road, Southwark",51.505461,-0.10454093,23,19,42
"001005 - Eversholt Street , Camden Town",51.53300545,-0.136792671,13,2,15
"002636 - Prince Albert Road, The Regent's Park",51.53589283,-0.160854428,5,18,23
"300100 - Limburg Road, Clapham Junction",51.4619231,-0.165297900000013,14,7,21
"002685 - South Kensington Station, South Kensington",51.494412,-0.173881,0,14,14
"000991 - Crosswall, Tower",51.51159481,-0.077121322,8,26,34
"003480 - Smith Square, Westminster",51.49580589,-0.127575233,0,18,18
"001150 - Queensway, Kensington Gardens",51.51031,-0.18740235,8,5,13
"001203 - Eastbourne Mews, Paddington",51.51641749,-0.179135079,20,13,33
"001016 - Hereford Road, Bayswater",51.513735,-0.193487,20,0,20
"000971 - Godliman Street, St. Paul's",51.51248445,-0.099141408,0,24,24
"200012 - Stepney Green Station, Stepney",51.521889,-0.04667,15,6,21
"001093 - Kennington Cross, Kennington",51.48894022,-0.111435796,44,0,44
"001220 - Imperial College, Knightsbridge",51.49942855,-0.179702476,0,19,19
"200051 - Percival Street, Finsbury",51.526153,-0.102208,20,1,21
"300002 - Brook Green South, Brook Green",51.49434708,-0.215804559,28,1,29
"001017 - Great Dover Street, The Borough",51.49738251,-0.089446947,24,7,31
"200090 - Pennington Street, Wapping",51.508622,-0.065006,8,34,42
"010628 - Cleaver Street, Kennington",51.488105,-0.110121,16,0,16
"200256 - Sutton Street, Shadwell",51.511066,-0.053558,27,2,29
"200021 - Hermitage Court, Wapping",51.504719,-0.063531,15,0,15
"200128 - Queen Street 2, Bank",51.511246,-0.093051,0,35,35
"300093 - Park Lane, Mayfair",51.50542628,-0.150817316,0,17,17
"001063 - Wood Street, Guildhall",51.51700801,-0.09388536,0,17,17
"200183 - Battersea Park Road, Nine Elms",51.4795017,-0.141770709,7,19,26
"002667 - Tower Wharf, Bermondsey",51.500845,-0.074704305,19,1,20
"200039 - Sail Street, Vauxhall",51.495656,-0.114605,13,8,21
"001166 - Bell Street , Marylebone",51.52202903,-0.165842551,15,3,18
"200185 - St. John's Road, Clapham Junction",51.46239255,-0.16829214,26,4,30
"002694 - Clapham Common Station, Clapham Common",51.461388,-0.13922146,18,2,20
"300101 - Little Brook Green, Brook Green",51.496664,-0.223868,13,20,33
"002648 - Waterloo Bridge, South Bank",51.50535447,-0.113656543,15,0,15
"003463 - Argyll Road, Kensington",51.50040123,-0.195455928,1,18,19
"200001 - Limerston Street, West Chelsea",51.485587,-0.18119,1,17,18
"001032 - New Inn Yard, Shoreditch",51.52452699,-0.079248081,1,17,18
"200195 - St Martins Close, Camden Town",51.538792,-0.138535,5,13,18
"300085 - Freston Road, Avondale",51.5129814,-0.219486603,18,4,22
"000975 - Theobald's Road , Holborn",51.52059681,-0.116688468,3,23,26
"001098 - Lower Thames Street, Monument",51.50930161,-0.084985356,3,20,23
"001030 - Lisson Grove, St. John's Wood",51.52644828,-0.172190727,10,6,16
"001217 - Serpentine Car Park, Hyde Park",51.505014,-0.17306032,1,14,15
"200022 - Saunders Ness Road, Cubitt Town",51.487129,-0.0090011,17,16,33
"200084 - Doddington Grove, Kennington",51.48692917,-0.102996299,33,1,34
"001210 - Nevern Place, Earl's Court",51.49334336,-0.194757949,13,7,20
"200044 - New Fetter Lane, Holborn",51.517428,-0.107987,0,20,20
"200175 - Wandsworth Rd, Isley Court, Wandsworth Road",51.46925984,-0.141812513,23,7,30
"002690 - City Road, Angel",51.530344,-0.100168,7,39,46
"001003 - Chapel Place, Marylebone",51.51530805,-0.147203711,0,29,29
"200006 - Hewison Street, Old Ford",51.533283,-0.028155,17,1,18
"000998 - Lollard Street, Vauxhall",51.49288067,-0.114934001,17,6,23
"001056 - Finsbury Square , Moorgate",51.52096262,-0.085634242,9,24,33
"003437 - Curzon Street, Mayfair",51.50706909,-0.145904427,0,15,15
"022160 - Chelsea Bridge, Pimlico",51.485821,-0.149004,0,15,15
"200003 - Cheshire Street, Bethnal Green",51.52388,-0.065076,21,5,26
"003470 - Great Percy Street, Clerkenwell",51.52891573,-0.115480888,16,7,23
"003435 - Gloucester Road (Central), South Kensington",51.49646288,-0.183289032,0,19,19
"300219 - Here East South, Queen Elizabeth Olympic Park",51.5465327935,-0.0205975904647,8,20,28
"001183 - Bramham Gardens, Earl's Court",51.49016361,-0.19039362,22,6,28
"200254 - Teviot Street, Poplar",51.518811,-0.011662,23,10,33
"300027 - Mile End Park Leisure Centre, Mile End",51.52059714,-0.032566533,12,35,47
"003424 - Broadcasting House, Marylebone",51.51811784,-0.144228881,1,16,17
"200132 - Gaywood  Street, Elephant & Castle",51.49605,-0.104193,22,21,43
"200096 - Green Park Station, Mayfair",51.506613,-0.142844,3,24,27
"200170 - Esmond Street, Putney",51.46231278,-0.211468596,30,0,30
"000963 - Bankside Mix, Bankside",51.50581776,-0.100186337,0,60,60
"300009 - World's End Place, West Chelsea",51.48180515,-0.18027465,17,2,19
"200197 - Barons Court Station, West Kensington",51.49021762,-0.215087092,4,25,29
"300029 - Lee Valley VeloPark, Queen Elizabeth Olympic Park",51.549369,-0.015717614,21,23,44
"001062 - Braham Street, Aldgate",51.51423368,-0.073537654,0,32,32
"200041 - Antill Road, Mile End",51.528224,-0.037471,14,15,29
"001023 - River Street , Clerkenwell",51.52916347,-0.109970527,17,0,17
"200078 - Aberfeldy Street, Poplar",51.513548,-0.005659,15,0,15
"200123 - Burdett Road, Mile End",51.516196,-0.029138,20,10,30
"300053 - Stephendale Road, Sands End",51.46822047,-0.190346493,28,19,47
"003430 - Central House, Aldgate",51.515231,-0.07015,0,16,16
"200144 - Sea Containers, South Bank",51.508033,-0.10682363,0,28,28
"200222 - Danvers Street, West Chelsea",51.48256792,-0.172078187,15,5,20
"002586 - Cloudesley Road, Angel",51.53440868,-0.109025404,15,20,35
"200079 - Ram Street, Wandsworth",51.45752945,-0.192165613,21,3,24
"001172 - Queen's Gate (South), South Kensington",51.49247977,-0.178433004,1,24,25
"200109 - Alpha Grove, Millwall",51.497304,-0.022793,12,11,23
"200082 - St. Mary & St. Michael Church, Stepney",51.51417,-0.052099,9,15,24
"000973 - Bethnal Green Road, Shoreditch",51.52364804,-0.074754872,0,33,33
"002698 - Aberdeen Place, St. John's Wood",51.524826,-0.176268,7,9,16
"200226 - Kingsway Southbound, Strand",51.513875,-0.117774,0,32,32
"001180 - Bourne Street, Belgravia",51.490959,-0.1532331,6,10,16
"003461 - Sloane Avenue, Knightsbridge",51.4931848,-0.167894973,1,24,25
"300060 - Brandon Street, Walworth",51.489102,-0.0915489,22,0,22
"001039 - Wapping High Street, Wapping",51.504904,-0.06797,13,4,17
"300095 - Michael Road, Walham Green",51.47727637,-0.189210466,20,17,37
"003448 - Webber Street , Southwark",51.50069361,-0.102091246,33,12,45
"200024 - Queensbridge Road, Haggerston",51.53385,-0.06992,24,9,33
"200069 - Knaresborough Place, Earl's Court",51.49363156,-0.190603326,10,6,16
"001041 - Westbourne Grove, Bayswater",51.51552971,-0.190240716,15,8,23
"300064 - Ranelagh Gardens, Fulham",51.46760141,-0.20682737,23,11,34
"000969 - Gower Place , Euston",51.52522753,-0.13518856,0,16,16
"003464 - Green Street, Mayfair",51.51227622,-0.157436972,2,13,15
"300089 - Ormonde Gate, Chelsea",51.48796408,-0.161765173,4,20,24
"000959 - Milroy Walk, South Bank",51.50724437,-0.106237501,6,22,28
"001230 - Millennium Hotel, Mayfair",51.5109192966489,-0.1511263847351,2,23,25
"000999 - Queen Street 1, Bank",51.51155322,-0.0929401,0,21,21
"300088 - Queensdale Road, Shepherd's Bush",51.50659035,-0.216104479,22,5,27
"001195 - St. George's Square, Pimlico",51.488226,-0.135635511,16,0,16
"300010 - Surrey Lane, Battersea",51.47518024,-0.167160736,22,0,22
"200119 - Dorothy Road, Clapham Junction",51.46506424,-0.163750945,24,0,24
"000972 - Hampstead Road, Euston",51.52554222,-0.138231303,2,46,48
"022171 - Red Lion Street, Holborn",51.51824,-0.11655,0,33,33
"003433 - Sadlers Sports Centre, Finsbury",51.52486887,-0.099489485,2,12,14
"003454 - Denyer Street, Knightsbridge",51.49358391,-0.165101392,10,20,30
"200174 - Mostyn Grove, Bow",51.530535,-0.025492,20,25,45
"010625 - Penfold Street, Marylebone",51.52289229,-0.171681991,4,9,13
"200216 - Clements Road, Bermondsey",51.4954,-0.061698585,15,7,22
"300021 - Podium, Queen Elizabeth Olympic Park",51.538718,-0.011889482,23,13,36
"001157 - Black Lion Gate, Kensington Gardens",51.50990837,-0.187842717,11,5,16
"200217 - Disraeli Road, Putney",51.4616107,-0.2161458,27,6,33
"200158 - Whiston Road, Haggerston",51.534464,-0.076341,6,12,18
"000990 - Cotton Garden Estate, Kennington",51.4907579,-0.106323685,22,0,22
"200029 - Finlay Street, Fulham",51.4768851,-0.215895601,22,1,23
"300237 - Tate Modern, Bankside",51.5067252868,-0.0988072461627,0,29,29
"001072 - Waterloo Station 3, Waterloo",51.50379168,-0.11282408,31,1,32
"003420 - Sedding Street, Sloane Square",51.49313,-0.156876,0,25,25
"200177 - Santos Road, Wandsworth",51.45705988,-0.200806304,15,15,30
"300011 - Victoria Park Road, Hackney Central",51.53642464,-0.054162264,33,1,34
"200196 - Simpson Street, Clapham Junction",51.47084722,-0.17070367,16,7,23
"002703 - Fire Brigade Pier, Vauxhall",51.49369988,-0.121394101,22,7,29
"001207 - Tavistock Street, Covent Garden",51.51196803,-0.120718759,1,27,28
"000978 - Russell Square Station, Bloomsbury",51.52341837,-0.124121774,1,25,26
"001084 - Pindar Street, Liverpool Street",51.520955,-0.083493552,1,22,23
"001187 - St. John's Wood Road, St. John's Wood",51.5272947,-0.174653609,20,15,35
"001034 - Bruton Street, Mayfair",51.51073687,-0.144165239,0,21,21
"300043 - St. Peter's Terrace, Fulham",51.47893931,-0.208485293,18,5,23
"002692 - Waterloo Station 2, Waterloo",51.50391973,-0.11342629,38,5,43
"300038 - Star Road, West Kensington",51.48724429,-0.205279052,19,4,23
"001170 - Horseferry Road, Westminster",51.49481649,-0.13045856,13,3,16
"001035 - Boston Place, Marylebone",51.522511,-0.162298,17,7,24
"001094 - Wright's Lane, Kensington",51.50039792,-0.193068385,15,17,32
"000966 - New Kent Road, The Borough",51.49443626,-0.092921165,32,0,32
"200026 - Greenland Road, Camden Town",51.539099,-0.141728,21,14,35
"000986 - Finsbury Library , Finsbury",51.52671796,-0.104298194,15,14,29
"000982 - Holborn Circus, Holborn",51.51795029,-0.108657431,1,38,39
"300217 - Here East North, Queen Elizabeth Olympic Park",51.5487311915,-0.0226065549321,27,1,28
"003502 - Palissy Street, Shoreditch",51.526293,-0.073955,7,19,26
"300243 - Good's Way, King's Cross",51.5346677396,-0.125078652873,13,13,26
"200048 - Page Street, Westminster",51.493978,-0.127554,14,8,22
"001148 - Queen Mother Sports Centre, Victoria",51.49357351,-0.139956043,18,8,26
"001069 - Eaton Square, Belgravia",51.49654462,-0.150905245,0,17,17
"200145 - Gloucester Avenue, Camden Town",51.537349,-0.147154,13,7,20
"300091 - Hortensia Road, West Brompton",51.48176572,-0.185273723,26,2,28
"300234 - Stratford Station, Stratford",51.541793,-0.00481,16,8,24
"003452 - Panton Street, West End",51.50963938,-0.131510949,0,19,19
"001092 - Moorfields, Moorgate",51.51906932,-0.088285377,2,51,53
"200136 - BBC White City, White City",51.514767,-0.225787,23,13,36
"200176 - Sheepcote Lane, Battersea",51.47053858,-0.163041605,21,7,28
"000983 - Euston Road, Euston",51.5262363,-0.134407652,0,24,24
"003431 - Grafton Street, Mayfair",51.5099923,-0.143495266,0,15,15
"001225 - George Street, Marylebone",51.517703,-0.154106,0,26,26
"200046 - Napier Avenue, Millwall",51.487679,-0.021582,17,1,18
"200089 - Chrisp Street Market, Poplar",51.5112,-0.014438,14,2,16
"200097 - Beryl Road, Hammersmith",51.48814438,-0.222456468,7,17,24
"200045 - Garnet Street, Shadwell",51.508447,-0.055167,11,12,23
"300036 - Teversham Lane, Stockwell",51.47614939,-0.1232585,38,0,38
"200155 - Gascoyne Road, Victoria Park",51.541515,-0.038557746,7,11,18
"200038 - Ackroyd Drive, Bow",51.520398,-0.026768,28,0,28
"003441 - Vicarage Gate, Kensington",51.50472376,-0.192538767,7,11,18
"000989 - Murray Grove , Hoxton",51.53089041,-0.089782579,13,13,26
"001178 - Cleveland Gardens, Bayswater",51.515607,-0.183118788,15,0,15
"001145 - Bucknall Street, Covent Garden",51.51615,-0.12841769999999997,0,16,16
"002687 - Brick Lane Market, Shoreditch",51.52261762,-0.071653961,3,21,24
"200244 - Hollybush Gardens, Bethnal Green",51.527607,-0.057133,8,21,29
"300074 - Newton Street, Covent Garden",51.51612862,-0.120909408,20,1,21
"300047 - Alfreda Street, Battersea Park",51.47505096,-0.150908371,20,1,21
"200138 - Heron Quays DLR, Canary Wharf",51.502661,-0.021596,2,25,27
"300248 - Sopwith Way, Battersea Park",51.4811219398,-0.149035374873,23,5,28
"300079 - London Street, Paddington",51.515117,-0.17371276,13,0,13
"001177 - Seville Street, Knightsbridge",51.50185512,-0.159237081,1,25,26
"022183 - Crinan Street, King's Cross",51.534474,-0.122203,17,3,20
"001229 - High Holborn , Covent Garden",51.516226,-0.124826,2,16,18
"200020 - Shadwell Station, Shadwell",51.511088,-0.057159,24,7,31
"200018 - Spindrift Avenue, Millwall",51.49109,-0.018716,35,0,35
"003434 - Sancroft Street, Vauxhall",51.48947903,-0.115156562,23,0,23
"300069 - Harcourt Terrace, West Brompton",51.48795853,-0.187404506,17,5,22
"300203 - Euston Square Gardens, Euston",51.527068,-0.13186102,6,23,29
"000979 - Wenlock Road , Hoxton",51.53099181,-0.093903825,12,12,24
"200252 - Bow Church Station, Bow",51.528169,-0.018703,14,23,37
"001120 - Chepstow Villas, Notting Hill",51.51213691,-0.201554966,14,11,25
"022173 - Old Ford Road, Bethnal Green",51.531127,-0.048017,16,8,24
"200076 - Westminster Bridge Road, Elephant & Castle",51.498386,-0.107913,20,6,26
"200033 - Philpot Street, Whitechapel",51.515256,-0.058641,28,2,30
"300250 - Temple Gardens, Temple",51.510981,-0.10832249,0,23,23
"001193 - Kensington Gore, Knightsbridge",51.50143293,-0.178656971,0,22,22
"200113 - Smugglers Way, Wandsworth",51.46108367,-0.191722864,22,0,22
"300072 - Broadley Terrace, Marylebone",51.52456169,-0.165668686,6,11,17
"000994 - Tanner Street, Bermondsey",51.50064702,-0.078600401,30,11,41
"002691 - Howland Street, Fitzrovia",51.520994,-0.139016,0,29,29
"001081 - Liverpool Road (N1 Centre), Angel",51.53450449,-0.106992706,9,11,20
"001205 - Black Prince Road, Vauxhall",51.4908679,-0.116911864,7,11,18
"200025 - London Fields, Hackney Central",51.54119,-0.058826101,11,4,15
"200014 - Gunmakers Lane, Old Ford",51.535179,-0.03338,16,0,16
"200135 - Selby Street, Whitechapel",51.521905,-0.063386,9,6,15
"001029 - Windsor Terrace, Hoxton",51.52915444,-0.093421615,9,14,23
"000974 - Guilford Street , Bloomsbury",51.52334672,-0.120202614,0,31,31
"022182 - South Parade, Chelsea",51.48902,-0.17524,7,9,16
"300025 - Archbishop's Park, Waterloo",51.49824168,-0.117495865,0,23,23
"300013 - Austin Road, Battersea Park",51.474376,-0.155442787,21,1,22
"300033 - Putney Rail Station, Putney",51.46071722,-0.216526155,12,8,20
"001112 - Nutford Place, Marylebone",51.5165179,-0.164393768,5,12,17
"001050 - Park Road (Baker Street), The Regent's Park",51.52451738,-0.158963647,2,19,21
"001188 - London Zoo Car Park, The Regent's Park",51.53692216,-0.150181444,29,7,36
"300200 - East Village, Queen Elizabeth Olympic Park",51.546326,-0.00993526,29,4,33
"001224 - Vauxhall Street, Vauxhall",51.486965,-0.116625,17,1,18
"001199 - The Tennis Courts, The Regent's Park",51.52536703,-0.153463612,8,6,14
"022180 - Cheapside, Bank",51.51397065,-0.09294031,1,42,43
"300040 - Ada Street, Hackney Central",51.53571683,-0.060291813,35,9,44
"001086 - Baker Street, Marylebone",51.51891348,-0.156166631,4,18,22
"001216 - Swan Street, The Borough",51.50029631,-0.092762704,21,4,25
"300252 - Canada Water Station, Rotherhithe",51.498439,-0.049150215,30,4,34
"003486 - St. Luke's Church, Chelsea",51.48971651,-0.170194408,1,19,20
"300082 - Bridge Avenue, Hammersmith",51.49208492,-0.229116862,11,2,13
"003499 - Prince Consort Road, Knightsbridge",51.49980661,-0.176415994,0,15,15
"001153 - Pall Mall East, West End",51.50777049,-0.130699733,0,21,21
"300045 - Albert Bridge Road, Battersea Park",51.47439218,-0.163347594,19,0,19
"200111 - Abbotsbury Road, Holland Park",51.501391,-0.205991,15,9,24
"300077 - Ingrave Street, Clapham Junction",51.46745485,-0.172293499,25,5,30
"001051 - Shoreditch Park, Hoxton",51.53404294,-0.086379717,21,9,30
"200030 - Driffield Road, Old Ford",51.534137,-0.037366,8,9,17
"200066 - Import Dock, Canary Wharf",51.505772,-0.016460175,2,35,37
"200206 - Chicheley Street, South Bank",51.502698,-0.1167474,14,9,23
"001004 - Doric Way , Somers Town",51.5288338,-0.132250369,23,27,50
"001042 - Woodstock Street, Mayfair",51.51410514,-0.147301667,0,19,19
"200182 - Rainville Road, Hammersmith",51.48373225,-0.223852256,33,3,36
"002679 - George Row, Bermondsey",51.498585,-0.068981764,19,1,20
"022159 - Ebury Bridge, Pimlico",51.490491,-0.149186,8,20,28
"001137 - Harper Road, The Borough",51.49859784,-0.096191134,36,6,42
"001142 - Tooley Street, Bermondsey",51.5034938,-0.07962099,10,16,26
"003467 - Dock Street, Wapping",51.5097860151,-0.0681619805156,12,16,28
"300231 - Lambeth Palace Road, Waterloo",51.5000891978,-0.116628700672,1,31,32
"300054 - Chesilton Road, Fulham",51.47569809,-0.20587627,16,4,20
"001151 - Whitehall Place, Strand",51.50654321,-0.123179697,1,23,24
"200235 - Manbre Road, Hammersmith",51.485743,-0.223616,26,0,26
"003497 - Rathbone Street, Fitzrovia",51.51816295,-0.135025698,0,15,15
"200049 - St. Katharine's Way, Tower",51.505697,-0.070542,16,7,23
"001055 - Wellington Road, St. John's Wood",51.53304322,-0.172528678,10,1,11
"300247 - Cranmer Road, Stockwell",51.479601,-0.11147178,21,0,21
"200067 - Princedale Road , Holland Park",51.50646524,-0.208486599,6,14,20
"200019 - Malmesbury Road, Bow",51.529452,-0.027616,7,12,19
"300097 - Gwendwr Road, West Kensington",51.491026,-0.209121,13,16,29
"300206 - Saltoun Road, Brixton",51.460232,-0.11537509,40,0,40
"022163 - Southwark Station 2, Southwark",51.504044,-0.104778,38,6,44
"300059 - The Blue, Bermondsey",51.492221,-0.06251309999998966,17,4,21
"001179 - Chelsea Green, Chelsea",51.49066456,-0.166485083,6,8,14
"003440 - Royal Avenue 1, Chelsea",51.489932,-0.162727,0,9,9
"001139 - Carey Street, Holborn",51.51501025,-0.112753217,2,13,15
"003473 - Belgrave Square, Belgravia",51.49941247,-0.152317537,1,16,17
"001222 - Goswell Road (City Uni), Finsbury",51.528246,-0.10102611,3,13,16
"003456 - Portugal Street, Holborn",51.51494305,-0.11614642,0,16,16
"001206 - Montpelier Street, Knightsbridge",51.49888404,-0.165471605,5,10,15
"200061 - Westfield Southern Terrace ,Shepherd's Bush",51.506256,-0.218337,28,0,28
"200102 - Harford Street, Mile End",51.521564,-0.039264,7,13,20
"002633 - Palace Gardens Terrace, Notting Hill",51.50860544,-0.193764092,14,20,34
"001186 - Belvedere Road 1, South Bank",51.50613324,-0.114686385,27,9,36
"003481 - Rodney Road , Walworth",51.49148474,-0.090220911,13,10,23
"200192 - Fawcett Close, Battersea",51.46916161,-0.174485792,25,10,35
"300019 - Felsham Road, Putney",51.464786,-0.215618902,11,5,16
"200191 - Spencer Park, Wandsworth Common",51.45787019,-0.174691623,10,13,23
"200173 - Courland Grove, Wandsworth Road",51.4729184,-0.132102704,37,3,40
"300039 - Wendon Street, Old Ford",51.53603947,-0.026262677,17,0,17
"001159 - Berry Street, Clerkenwell",51.52285301,-0.099994052,1,38,39
"300068 - Humbolt Road, Fulham",51.48321729,-0.211860644,13,12,25
"001080 - Great Tower Street, Monument",51.51048489,-0.082989638,0,22,22
"200064 - Regent's Row , Haggerston",51.535678,-0.062546,16,6,22
"300080 - Culvert Road, Battersea",51.4710956,-0.157850096,10,16,26
"000992 - St. John Street, Finsbury",51.52836014,-0.104724625,9,8,17
"002665 - Lord's, St. John's Wood",51.5291212008901,-0.171185284853,7,16,23
"200015 - Ladbroke Grove Central, Ladbroke Grove",51.511624,-0.205921,8,11,19
"001044 - The Guildhall, Guildhall",51.51573534,-0.093080779,0,17,17
"200053 - Killick Street, King's Cross",51.5338,-0.118677,18,2,20
"300216 - Gas Holders, Battersea Park",51.477966,-0.14785703,21,2,23
"200159 - Goldsmith's Row, Haggerston",51.531864,-0.066035,20,2,22
"001167 - South Wharf Road, Paddington",51.51733558,-0.175810943,12,1,13
"200229 - Fulham Park Road, Fulham",51.473471,-0.20782,24,2,26
"001047 - Falkirk Street, Hoxton",51.53095071,-0.078505384,17,9,26
"300226 - Copper Box Arena, Queen Elizabeth Olympic Park",51.544909,-0.0205426,10,18,28
"200187 - Morie Street, Wandsworth",51.45995384,-0.190184054,28,0,28
"200098 - Aintree Street, Fulham",51.48102131,-0.209973497,21,1,22
"002682 - Turquoise Island, Notting Hill",51.51431171,-0.200838199,17,1,18
"200080 - Russell Gardens, Olympia",51.500088,-0.211316,10,13,23
"001134 - Warwick Road, Olympia",51.49671237,-0.20528437,12,22,34
"001146 - Tysoe Street, Clerkenwell",51.52644342,-0.109256828,14,6,20
"001048 - Queen Victoria Street, St. Paul's",51.51196176,-0.097441687,0,32,32
"001160 - Craven Street, Strand",51.50810309,-0.12602103,0,23,23
"000985 - Hatton Garden, Holborn",51.51882555,-0.108028472,0,28,28
"003504 - Moor Street, Soho",51.51352755,-0.130110822,0,15,15
"300225 - Normandy Road, Stockwell",51.473874,-0.11258096,29,0,29
"300001 - Sandilands Road, Walham Green",51.473611,-0.191803,21,0,21
"200227 - Westfield Library Corner, Shepherd's Bush",51.506093,-0.2242237,26,0,26
"200035 - Walmer Road, Avondale",51.510101,-0.211358,10,13,23
"002677 - Natural History Museum, South Kensington",51.49559291,-0.179077626,0,42,42
"200125 - Putney Bridge Station, Fulham",51.468814,-0.210279,18,3,21
"003498 - Geraldine Street, Elephant & Castle",51.49612799,-0.106000855,14,1,15
"001013 - St. Chad's Street, King's Cross",51.53005939,-0.120973687,22,1,23
"300032 - Victoria & Albert Museum, South Kensington",51.495898,-0.173009,0,29,29
"200081 - Coomer Place, West Kensington",51.4835707,-0.2020387000000028,23,2,25
"200157 - Fournier Street, Whitechapel",51.519362,-0.074431,0,17,17
"001227 - Devonshire Terrace, Bayswater",51.51348,-0.17977,14,1,15
"022166 - Albert Gardens, Stepney",51.51328,-0.047784,25,5,30
"300241 - Handyside Street, King's Cross",51.5372406,-0.12480740000000878,2,20,22
"200115 - Flamborough Street, Limehouse",51.5128711,-0.0389866,21,1,22
"200156 - Pott Street, Bethnal Green",51.527152,-0.058005,10,5,15
"003485 - Tyers Gate, Bermondsey",51.50088934,-0.083159352,8,27,35
"000995 - Little Argyll Street, West End",51.51449962,-0.141423695,5,13,18
"001219 - Lower Marsh, Waterloo",51.5001394,-0.11393599999999537,5,12,17
"200148 - Ansell House, Stepney",51.520019,-0.05438,15,24,39
"200011 - Furze Green, Bow",51.519265,-0.021345,20,15,35
"000993 - Drummond Street , Euston",51.527326,-0.13605286,4,23,27
"300228 - Westferry Circus, Canary Wharf",51.5057030357,-0.0277727426235,6,27,33
"001025 - Bolsover Street, Fitzrovia",51.52351808,-0.143613641,0,18,18
"200178 - Buckingham Gate, Westminster",51.49886563,-0.137424571,1,14,15
"010621 - Upper Grosvenor Street, Mayfair",51.51013066,-0.155757901,1,16,17
"001076 - Walnut Tree Walk, Vauxhall",51.49368637,-0.111014912,20,0,20
"001223 - Buxton Street 1, Shoreditch",51.521776,-0.068856,12,29,41
"300253 - Bermondsey Station, Bermondsey",51.497995,-0.063471392,26,3,29
"002649 - Sardinia Street, Holborn",51.515208,-0.117863,0,22,22
"200246 - Eagle Wharf Road, Hoxton",51.53356,-0.09315,39,1,40
"300035 - Carnegie Street, King's Cross",51.53546778,-0.11619105,12,27,39
"003457 - Rochester Row, Westminster",51.49582705,-0.13547809,2,10,12
"300087 - Imperial Road, Sands End",51.47514228,-0.187278987,31,4,35
"001074 - Newgate Street , St. Paul's",51.515768,-0.09989400000000614,0,34,34
"001164 - Portland Place, Marylebone",51.52071513,-0.14521173,0,34,34
"300048 - Stainsby Road , Poplar",51.51542791,-0.02356501,9,13,22
"001202 - Wellington Street , Strand",51.51175646,-0.119643424,18,2,20
"001165 - Riverlight North, Nine Elms",51.482362,-0.13612398,20,2,22
"003500 - Baldwin Street, St. Luke's",51.52702563,-0.088542771,8,10,18
"300075 - Upcerne Road, West Chelsea",51.47816972,-0.18243547,17,10,27
"002678 - Farm Street, Mayfair",51.50935171,-0.14744969,1,13,14
"001107 - Gloucester Road Station, South Kensington",51.49418566,-0.18267094,0,15,15
"200043 - Bishop's Avenue, Fulham",51.47303687,-0.214749808,23,23,46
"200250 - Cleveland Way, Stepney",51.520893,-0.051394,17,17,34
"200181 - Richmond Way, Shepherd's Bush",51.50035306,-0.217515071,12,14,26
"022175 - Canton Street, Poplar",51.511811,-0.025626,17,4,21
"001123 - Southampton Place, Holborn",51.51760685,-0.121328408,0,19,19
"000996 - Borough High Street, The Borough",51.50069491,-0.094524319,6,14,20
"002660 - Frith Street, Soho",51.51310333,-0.13121385,0,16,16
"001033 - Paddington Street, Marylebone",51.52058381,-0.154701411,0,15,15
"200120 - Grant Road East, Clapham Junction",51.46489445,-0.17302926,21,4,25
"300078 - Oxford Road, Putney",51.46079243,-0.212607684,28,1,29
"001115 - Ilchester Place, Kensington",51.50074359,-0.202759212,2,22,24
"003496 - St Mary's Hospital, Paddington",51.518268,-0.17110323,3,16,19
"200112 - Cadogan Close, Victoria Park",51.54211855,-0.028941601,11,10,21
"001117 - Lambeth North Station, Waterloo",51.49914063,-0.112031483,11,8,19
"001141 - Kingsway, Covent Garden",51.51440928,-0.118478757,0,16,16
"003501 - Clifton Street, Shoreditch",51.523196,-0.083067,6,18,24
"022177 - Christian Street, Whitechapel",51.513074,-0.064094,13,21,34
"200248 - Pitfield Street Central, Hoxton",51.53213,-0.08299,19,7,26
"200074 - Bury Place, Holborn",51.51742,-0.12318999999999392,0,19,19
"003476 - Hinde Street, Marylebone",51.51681444,-0.151926305,0,21,21
"200013 - Aston Street, Stepney",51.516,-0.038775,18,6,24
"003484 - Houghton Street, Strand",51.51362054,-0.116764211,0,14,14
"200234 - Bancroft Road, Bethnal Green",51.526041,-0.047218,19,0,19
"000962 - Stamford Street, South Bank",51.50556905,-0.111606696,26,1,27
"200166 - Southerton Road, Hammersmith",51.494499,-0.228188,33,2,35
"001097 - Northumberland Avenue, Strand",51.506767,-0.123702,3,34,37
"300006 - Clapham South, Clapham South",51.452997,-0.1486519000000044,26,2,28
"300063 - Burgess Park Albany Road, Walworth",51.48224,-0.0942844,28,0,28
"001046 - Vauxhall Bridge , Pimlico",51.48836528,-0.129361842,10,25,35
"200253 - Fore Street Avenue, Guildhall",51.517842,-0.090075,0,18,18
"002696 - Waterloo Station 1, Waterloo",51.50402794,-0.11386436,34,0,34
"003492 - Putney Pier, Wandsworth",51.466907,-0.216573,17,8,25
"001161 - Brushfield Street, Liverpool Street",51.518908,-0.079249,1,30,31
"200083 - Pritchard's Road, Bethnal Green",51.532091,-0.061419999999998254,11,15,26
"003494 - Foley Street, Fitzrovia",51.51918144,-0.140485596,2,20,22
"300015 - Binfield Road, Stockwell",51.47250956,-0.122831913,35,0,35
"300210 - Halford Road, West Kensington",51.483911,-0.19760944,21,3,24
"001116 - Emperor's Gate, South Kensington",51.49536226,-0.185296516,2,17,19
"003445 - Shoreditch High Street, Shoreditch",51.5263778,-0.078130921,11,29,40
"200124 - Clarendon Road, Avondale",51.51323001,-0.211593602,16,6,22
"200031 - East Ferry Road, Cubitt Town",51.49447,-0.014409,11,5,16
"300005 - Ethelburga Estate, Battersea Park",51.47729232,-0.16478637,28,1,29
"300020 - West Kensington Station, West Kensington",51.49087074,-0.206029743,10,8,18
"001087 - Belgrave Road, Victoria",51.49320445,-0.144132875,11,17,28
"300244 - The Metropolitan, Portobello",51.520509,-0.20080483,5,9,14
"001079 - Endsleigh Gardens, Euston",51.52683806,-0.130504336,14,15,29
"003493 - South Audley Street, Mayfair",51.50923,-0.15128999999998882,0,13,13
"200240 - Ferndale Road, Brixton",51.464019,-0.11578197,28,0,28
"200200 - Great Suffolk Street, The Borough",51.50173215,-0.100292412,11,8,19
"001036 - Crawford Street, Marylebone",51.52026,-0.157183945,0,17,17
"200047 - Bethnal Green Garden, Bethnal Green",51.52568,-0.055312,11,8,19
"003423 - Maida Vale, Maida Vale",51.529857,-0.18348604,27,11,38
"001009 - Taviton Street, Bloomsbury",51.52505093,-0.131161087,1,27,28
"003428 - Pancras Road, King's Cross",51.5341235,-0.129386874,9,6,15
"200231 - Abingdon Green, Westminster",51.49764,-0.12597218,1,17,18
"200134 - Albany Street, The Regent's Park",51.528302,-0.144466,25,0,25
"003444 - Penywern Road, Earl's Court",51.49159394,-0.192369256,1,15,16
"200037 - Rectory Square, Stepney",51.518369,-0.043371,11,9,20
"300031 - Islington Green, Angel",51.53638435,-0.102757578,8,10,18
"001027 - Warwick Avenue Station, Maida Vale",51.52334476,-0.183846408,17,0,17
"200179 - Silverthorne Road, Battersea",51.47286577,-0.148059277,28,0,28
"200146 - Newby Place, Poplar",51.508896,-0.012413,17,0,17
"300224 - New Spring Gardens Walk, Vauxhall",51.4878074485,-0.122759625866,35,0,35
"200219 - Osiers Road, Wandsworth",51.46067005,-0.198735357,28,2,30
"000984 - Finsbury Circus, Liverpool Street",51.51707521,-0.086685542,0,33,33
"003468 - Margery Street, Clerkenwell",51.52659961,-0.112432615,9,10,19
"001088 - Triangle Car Park, Hyde Park",51.50645179,-0.170279555,4,19,23
"300239 - Victory Place, Walworth",51.492807,-0.091938,21,1,22
"001213 - Curlew Street, Shad Thames",51.50227992,-0.074189225,15,5,20
"300041 - Finnis Street, Bethnal Green",51.52458353,-0.058631453,17,0,17
"200002 - Jubilee Street, Stepney",51.515975,-0.053177,17,8,25
"002695 - Cadogan Gardens, Chelsea",51.492462,-0.159919,1,14,15
"001064 - Old Street Station, St. Luke's",51.525615,-0.08853260000000773,3,31,34
"002686 - Royal College Street, Camden Town",51.536264,-0.133952,51,5,56
"001169 - Grosvenor Crescent, Belgravia",51.50135267,-0.153194766,0,16,16
"200105 - Bonny Street, Camden Town",51.541603,-0.138853,16,27,43
"200040 - Broomhouse Lane, Parsons Green",51.46841875,-0.199135704,27,0,27
"300086 - Fulham Broadway, Walham Green",51.47993289,-0.19411695,15,9,24
"200186 - Nantes Close, Wandsworth",51.46193072,-0.180791784,19,3,22
"022164 - Eaton Square (South), Belgravia",51.49456127,-0.15393398,12,17,29
"300028 - Everington Street, Fulham",51.48335692,-0.216305546,28,3,31
"003472 - Colombo Street, Southwark",51.50545935,-0.10569204,9,4,13
"002585 - Orsett Terrace, Bayswater",51.517932,-0.183716959,2,13,15
"001054 - East Road, Hoxton",51.52867339,-0.087459376,23,3,26
"000960 - Hop Exchange, The Borough",51.50462759,-0.091773776,0,52,52
"200101 - Monument Street, Monument",51.50964,-0.08497,2,18,20
"000976 - Longford Street, The Regent's Park",51.52559505,-0.144083893,1,16,17
"001083 - Commercial Street, Shoreditch",51.52127071,-0.0755789,1,15,16
"200242 - Merchant Street, Bow",51.526578,-0.027581,7,18,25
"300215 - St John's Crescent, Brixton",51.466232,-0.11317995,24,0,24
"001108 - North Wharf Road, Paddington",51.518623,-0.17660300000000007,15,6,21
"200126 - Usk Road, Clapham Junction",51.46348914,-0.182126248,19,11,30
"200016 - Castlehaven Road, Camden Town",51.542138,-0.145393,13,10,23
"200239 - Old Montague Street, Whitechapel",51.51793,-0.067937,5,13,18
"200060 - Drayton Gardens, West Chelsea",51.487196,-0.179369,8,9,17
"001015 - New Globe Walk, Bankside",51.5073853,-0.096440751,0,19,19
"300204 - Victoria Rise, Clapham Common",51.461376,-0.14780467,9,14,23
"001008 - Hatton Wall, Holborn",51.5216612,-0.109006325,2,22,24
"300220 - Farringdon Street, Holborn",51.516785,-0.10494775,0,24,24
"300092 - Hertford Road, De Beauvoir Town",51.53727795,-0.079201849,18,7,25
"003421 - Red Lion Square, Holborn",51.51943538,-0.119123345,0,16,16
"003507 - Store Street, Bloomsbury",51.519572,-0.13214036,0,28,28
"300211 - Ossulston Street, Somers Town",51.5293,-0.12827903,17,12,29
"300030 - Thorndike Close, West Chelsea",51.48089844,-0.183853573,24,0,24
"200065 - Lansdowne Walk, Ladbroke Grove",51.509591,-0.204666,11,9,20
"300057 - Westbourne Park Road, Portobello",51.51787005,-0.201005397,17,3,20
"002688 - Clifford Street, Mayfair",51.51066202,-0.142345694,0,16,16
"200071 - Hoxton Street, Hoxton",51.52959,-0.0801,9,16,25
"003442 - Abingdon Villas, Kensington",51.4973875,-0.197245586,1,14,15
"002680 - Harrowby Street, Marylebone",51.5173721,-0.1642075,0,16,16
"003462 - Royal Avenue 2, Chelsea",51.490083,-0.162418,0,10,10
"001184 - St. Mary Axe, Aldgate",51.51422502,-0.080660083,0,18,18
